flag	content
OPTIONS	Options
CONTROLS	Controls
COLORS	Colors
MODS	Mods
PREFERENCES	Preferences
CUTSCENES	Cutscenes
NAUGHTYNESS	Naughtyness
DOWNSCROLL	Downscroll
MIDDLESCROLL	Middlescroll
FLASHING_MENU	Flashing Menu
CAMERA_ZOOMING_ON_BEAT	Camera Zooming on Beat
FPS_COUNTER	FPS Counter
AUTO_PENIS	Auto Penis
AUTO_PAUSE	Auto Pause
KEYBOARD	Keyboard
GAMEPAD	Gamepad
UI	UI
NOTES	NOTES
OK	Ok
YES	Yes
NO	No
LOGOUT	Logout
LOGIN	Login
EXIT	exit