flag	content
OPTIONS_OPTIONS	Optionen
OPTIONS_CONTROLS	Steuerung
OPTIONS_COLORS	Farben
OPTIONS_MODS	Mods
OPTIONS_PREFERENCES	Pr채ferenz
OPTIONS_CUTSCENES	Zwischensequenze
OPTIONS_NAUGHTYNESS	Unzensierung
OPTIONS_DOWNSCROLL	Unteres scroll
OPTIONS_MIDDLESCROLL	Mittleres scroll
OPTIONS_FLASHING_MENU	Flackerndes Men체
OPTIONS_CAMERA_ZOOMING_ON_BEAT	Camera Zooming auf Beat
OPTIONS_FPS_COUNTER	FPS Z채hler
OPTIONS_AUTO_PENIS	Automatischer Penis
OPTIONS_AUTO_PAUSE	Automatische Pause
OPTIONS_KEYBOARD	Tastatur
OPTIONS_GAMEPAD	Gamepad
OPTIONS_UI	Oberfl채che
OPTIONS_NOTES	NOTES
OPTIONS_OK	Ok
OPTIONS_YES	Ja
OPTIONS_NO	Nein