flag	content
OPTIONS	Options
CONTROLS	Contrôles
COLORS	Couleurs
MODS	Mods
PREFERENCES	Préférences
CUTSCENES	Cinématiques
NAUGHTYNESS	Méchanceté
DOWNSCROLL	Downscroll
MIDDLESCROLL	Middlescroll
FLASHING_MENU	Menu Clignotant
CAMERA_ZOOMING_ON_BEAT	Zoom de la Caméra sur le Rythme
FPS_COUNTER	Compteur de FPS
AUTO_PENIS	Penis Auto
AUTO_PAUSE	Pause Auto
KEYBOARD	Clavier
GAMEPAD	Manette de Jeu
UI	INTERFACE
NOTES	NOTES
OK	Ok
YES	Oui
NO	Non
LOGOUT	Se Déconnecter
LOGIN	Se Connecter
EXIT	Sortir